1111111111111111111111111111111111
1E10000000000000000000000010000001
1010010100100000101001010101010101
1010010010101010001001000010010101
1P0C000000000000000000000000000001
1111111111111111111111111111111111