1111111111111111111111111111111111
1E00000000000000000000000010000001
10100101001000001010010C01C0010101
1010010010101010001001000010010101
1P00000000000000000000000000000001
1111111111111111111111111111111111