11111111111111111111111
10000000000C0C00C000001
10100000000000000000001
11E000000000P000C000001
10100000000000000000C01
10000000000C00000000001
1000000000000C000000001
10100000000000000000001
1000000000000000C000001
100000000000C0000000001
10000010000000C00000001
10000000C00000000000001
1C00C000000000000000001
10000000000000000000C01
10000000C00000000000001
10000000C00000000000001
10000000000000000000001
100000000C000000C000001
10000000000000000000001
11111111111111111111111