111111111111111
100000000000101
100000000000101
1000CCC000001C1
100000000001101
100000000100001
100000001000101
100000000000011
100001000000001
1P0000001001001
1000000E1000001
100000000000001
100000000000001
111111111111111