111111111111111
1C0000000000101
10000C000000101
1C00000000000C1
1C0C000000C1101
100000000100011
10C000001000101
1000CC000000011
10C001000000001
1P00C0001C01001
1000000E100C0C1
10C0C000CC00001
100000000000001
111111111111111